100,200,300,300,300,400,500
500,250,60,400,500,250,500
X,1,0,0,1,0,0
1,X,1,1,0,0,0
0,1,X,0,0,1,0
0,1,0,X,2,1,0
1,0,0,2,X,0,1
0,1,1,1,0,X,1
0,0,0,0,1,1,X