100,150,250,300,300,350,450,500
250,500,250,100,400,250,500,250
X,0,1,0,1,0,0,0
0,X,1,0,1,0,0,0
1,1,X,1,0,1,0,0
0,0,1,X,0,1,0,0
1,1,0,0,X,0,1,1
0,0,1,1,0,X,1,1
0,0,0,0,1,1,X,0
0,0,0,0,1,1,0,X