100,100,200,300,375,375,450,550
150,450,300,450,150,250,450,300
X,0,3,0,0,0,0,0
3,X,0,0,0,0,0,0
0,3,X,0,3,1,0,0
0,0,3,X,0,0,1,0
0,0,0,0,X,0,0,1
0,0,1,0,0,X,0,1
0,0,0,1,0,0,X,1
0,0,1,0,1,1,1,X